1111111111111
10000000C0011
10C00111100P1
10010000C0001
1001000010001
1000111100111
1C0110000E0C1
1111111111111
