1111111111111
10000000C0011
10C0011110001
1001p000C0001
1001000010001
1000111100011
1C011000000C1
1111111111111
1111111111111
10000000C0011
10C0011110001
10010000C0001
1001000010001
10001111E0011
1C01100P000C1
1111111111111
